NO ./textures/backroom_wall.xpm
SO ./textures/backroom_wall.xpm
WE ./textures/backroom_wall.xpm
EA ./textures/backroom_wall.xpm

F 210,196,126
C 222,216,185


                                                                
  111111111111111111111111111111111111111111111111111111111     
  100000000000000000000000000000000000000000000000000000001     
  100000000000000000000000000000000000000000000000000000001     
  100000000000000000000000000000000000000000000000000000001     
  100000000000000000000000000000000000000000000000000000001     
  100000000000000000000000000000000000000000000000000000001     
  100000000000000000000000000000000000000000000000000000001     
  111111111111111111111111111111111111111111111111111111111     
  100000001000000000000000101000010101010101000000000000001     
  10E011111011111101011100100000010000000100011110101010101     
  100010001000001000000100101000010101010101010000000000101     
  100010001001001001011100101000010000000100010000011111101     
  111010001111001001000111101000010101010101000000010000001     
  100010000000001001000000001000010000000100011110010000001     
  111011110110001011111011111110010111111100010000011100001     
  100000000000000000000000000000000000000000010000000000001     
  111111111111111111111111111111111111111110011111111111111     
  100000000000000000000000000000000000000000000000000000001     
  100000000000000000000000000000000000000000000000000000001     
  100000000000000000000000000000000000000000000000000000001     
  100000000000000000000000000000000000000000000000000000001     
  100000000000000000000000000000000000000000000000000000001     
  100000000000000000000000000000000000000000000000000000001     
  100000000000000000000000000000000000000000000000000000001     
  100000000000000000000000000000000000000000000000000000001     
  111111111111111111111111111111111111111111111111111111111     
                                                                
                                                                
                                                                
                                                                
                                                                
                                                                
                                                                
                                                                
                                                                
                                                                
                                                                
                                                                
                                                                
                                                                
                                                                
                                                                
                                                                
                                                                
                                                                
                                                                
                                                                
                                                                
                                                                
                                                                
                                                                
                                                                
                                                                
                                                                
                                                                
                                                                
                                                                
                                                                
                                                                
                                                                
                                                                
                                                                
                                                                
                                                                
                                                                
                                                                
                                                                
                                                                
                                                                
                                                                
                                                                
                                                                
                                                                
                                                                
                                                                
                                                                
                                                                
                                                                
                                                                
                                                                
                                                                
                                                                
                                                                
                                                                
                                                                
                                                                
                                                                
                                                                
                                                                
                                                                
                                                                
                                                                
                                                                
                                                                
                                                                