NO ./textures/backroom_wall.xpm
SO ./textures/backroom_wall.xpm
WE ./textures/backroom_wall.xpm
EA ./textures/backroom_wall.xpm

F 210,196,126
C 222,216,185


11111111111111111
10000000000000001
10E0101001011111111111
1000101111000001y1m001
11111000c100000101110111
1cccc1111110111101000101                                   
1cccc1000000010000010101      11111111111111111            
1cccc1010101011111110101      1c0c0c0c0c0c0c0c1            
1ccccY000000000001010101      10c0c0c0b0c0c0c01            
1cccc10101010111000000001     1c0c0c0c0c0c0c0c1             
1cccc1000000c1  111111111     10c0c0c000c0c0c01             
11D11111111111     111111111 111111111R11111111  
1000111111111      100000001 101     10111      
10c0100010001  1111101111101 1011111 100001     
100010r010c01  1000000001101 1000001 10101      
10c0100010001  1110111011101 101101  10101      
100011G111B1     101 10000001001101111011 1    
10000000000011111101 101111111000000000011g1         
10000000000000000001 10111011101101111011101          
10000000000011111111 10000000001101  10000001    
111111111111          111111111  1    111111   