NO ./textures/backroom_wall.xpm
SO ./textures/backroom_wall.xpm
WE ./textures/backroom_wall.xpm
EA ./textures/backroom_wall.xpm

F 210,196,126
C 222,216,185


                                                                
  111111111111111111111111111111111111111111111111111111111     
  100001001000101001001000000010001000100100000000000000001     
  100001000000000001000011100010001000100111011100000000001     
  100001001011101001001000110010001000100000000100000000001     
  111101001000101001001011110010001000111110000100000000001     
  100000001000101011001010100000011110000000011111111111111     
  111111001000100000001000000010000000000000000000000000001     
  111111111111111111111111111111111111111111111111111110011     
  100000001000000000000000101000010101010101000000000000001     
  10E011111011111101011100100000010000000100011110101010101     
  100010001000001000000100101000010101010101010000000000101     
  100010001001001001011100101000010000000100010000011111101     
  111010001111001001000111101000010101010101000000010000001     
  100010000000001001000000001000010000000100011110010000001     
  111011110110001011111011111110010111111100010000011100001     
  100000000000000000000000000000000000000000010000000000001     
  111111111111111111111111111111111111111110011111111111111     
  100000000100000000111000000100010000000000000000000000011     
  100000000101111111100010100000010010010010010010010010011     
  100000000101000000101110100101110000000000000000000000011     
  100000000100000000100000000100000000000000000000000000011     
  111101111101110111100001111101110010010010010010010010011     
  101000100000100000100000100101010000000000000000000000011     
  101000100000100000100000100000010000000000000000000000011     
  100000000000000000000000000001010010010010010010010010011     
  111111111111111111111111111111111111111111111111111111111     
                                                                