NO ./textures/024.xpm
SO ./textures/024.xpm
WE ./textures/024.xpm
EA ./textures/024.xpm

F 108,108,108
C 115,74,41

                         11111111111111111111111111111
                         10000000000000000000000000001
1111111111111            10k0k0k0k0k0k0k0k0k0k0k0k0k01
1000000Y00k01            10k0k0k0k0k0k0k0k0k0k0k0k0k01
10000k0111111            10000000000000000000000000001
10r00b0G00k01            10k0k0k0k0k0k0k0k0k0k0k0k0k01
100cm00100001            10000000000000000000000000001
10y00g011111111111111111111111111D11111111111111111111
1000000B0000cccccccccccccccccccccccccccccc1
11D11R1100000000000000000000000000000000001
1000100100000c0c0c0c0c0c0c0c0c0c0c0c0c0c0c1
1111111111111111111111111111111111111111111