NO ./textures/024.xpm
SO ./textures/024.xpm
WE ./textures/024.xpm
EA ./textures/024.xpm

F 108,108,108
C 115,74,41

1111111111111
10S0000100001
1000000Y00001
1000000111111
10r00b0G00001
1000m00100001
10y00g0111111
1000000B00001
11D11R1100001
1000100100001
1111111111111