NO ./textures/024.xpm
SO ./textures/024.xpm
WE ./textures/024.xpm
EA ./textures/024.xpm

F 108,108,108
C 115,74,41

1111111111111
10000001000N1
1000000Y00001
1000000111111
10r00b0G00001
100cm00100001
10y00g0111111111111111111111111111111111111
1000000B0000cccccccccccccccccccccccccccccc1
11D11R1100000000000000000000000000000000001
1000100100000c0c0c0c0c0c0c0c0c0c0c0c0c0c0c1
1111111111111111111111111111111111111111111