NO ./textures/024.xpm
SO ./textures/043.xpm
WE ./textures/089.xpm
EA ./textures/090.xpm

F 220,100,0
C 225,30,0

                                                                        
                                                                        
 1111                                                                   
 1001                                                                   
 1001                     11111111111111                           
 1001                     10000000000001                                
 1001                     10000001111101                               
 1001    1111111          10000001   101                                
 1001    1000001   111111111111111111101                                
 1001    1000001   100000000000000000001                                
 100111111110111111101010101010101010101                                
 100000000000000000000000000000000000001                                
 100111111110111111101010101010101010101                                
 1001    1000001   100000000000000000001                             
 1001    1000001   101010101010101010101                                
 1001    1111111   111111111111111111111                                
 1001                                                                   
 1001                                                                   
 1N01                                                                  
 1111                                                                  
                                                                        