NO ./textures/024.xpm
SO ./textures/043.xpm
WE ./textures/089.xpm
EA ./textures/090.xpm

F 0,0,155
C 0,0,255

I ./textures/banana_frame_0.xpm

                                                                        
                                                                        
 1111                                                                   
 1001                                                                   
 1001                     11111111111111                           
 1001                     10000000000001                                
 1001                     10000001111101                               
 1001    1111111          10000001   101                                
 1001    1I000I1   111111111111111111101                                
 1001    1I000I1   100000000000000000001                                
 100111111110111111101010101010101010101                                
 100000000000000000000000000000000000001                                
 100111111110111111101010101010101010101                                
 10I1    1I000I1   100000000000000000001                             
 10I1    1I000I1   101010101010101010101                                
 10I1    1111111   111111111111111111111                                
 10I1                                                                   
 10I1                                                                   
 1N01                                                                  
 1111                                                                  
                                                                        